111111111111
1E00000000C1
100000000001
1C00000000P1
111111111111
