11111111111111111111111111
1E000000000000000000000001
10000000000000000000000001
100000C000000000000C000001
10000000000000000000000001
10000000000P00000000000001
10000000000000000000000001
10000000000000000000000001
10000C00000000000000000001
10000000000000000000000001
10000000000000000000000001
10000000000000000000000001
10000000000000000000000001
10000000000000000000000001
10000000000000000000000001
10000000000000000000000001
10000000000000000000C00001
10000000000000000000000001
10000000000000000000000001
10000000000000000000000001
11111111111111111111111111
