1111111111111111111111111111111111111111
10000000000C0000000000000000000000000001
100000E00000000000000C000000000000000001
100000000000000P000000000000000000000001
1000000000000000000000000000000000000001
100000000000000000000000000000C000000001
1000000000000000000000000000000000000001
1000000000000000000000000000000000000001
100000C000000000000000000000000000000001
1000000000000000000000000000000000000001
1111111111111111111111111111111111111111