11111111
1E000001
10000001
1C0000P1
11111111
