1111111111111
1E00000000001
1000000000001
100000C000001
1000000000001
10000000000P1
1111111111111
