11111111
1E000001
11100001
1C1000P1
11111111