11111111
1E0000D1
10000001
1C0000P1
11111111
