11111111
1E100001
11100001
1C0000P1
11111111
