111111111111111111
 1000000000000001
  10000000000001
   100000000001
    1000000001
     10000001
      100001
       1001
        11
        